acknowledge	en
aquasafe	en
archibald	en
baby	en
based	en
beneficiary	en
benign	en
bounces	en
breakaway	en
bringing	en
bryant	en
buddies	en
caribbean	en
chambermaid	en
changed	en
coke	en
collar	en
comforting	en
counterparties	en
deals	en
delhi	en
departure	en
desisted	en
dessert	en
diligent	en
directed	en
disgusting	en
doubts	en
drag	en
encyclopedic	en
enemies	en
equipment	en
exposed	en
expulsion	en
fervor	en
fixeded	en
form	en
friendship	en
fusion	en
glacier	en
greensboro	en
grusendorf	en
haunt	en
immigrants	en
imperative	en
inconvenient	en
inoperable	en
islamophobia	en
jalapeno	en
lane	en
lanka	en
leakage	en
lifted	en
lucy	en
machine	en
maine	en
mart	en
maximized	en
mcginnis	en
meanest	en
medium	en
michele	en
misto	en
modus	en
morale	en
moral	en
network	en
oblivious	en
orange	en
painting	en
paradoxically	en
pentagon	en
phones	en
pinky	en
platforms	en
propose	en
puppets	en
revealing	en
ring	en
rockies	en
skills	en
slept	en
smaller	en
spokesperson	en
sprang	en
stores	en
succeed	en
succinctly	en
symbolizes	en
talk	en
tamils	en
tear	en
teenager	en
title	en
touch	en
turnover	en
unknowledgeable	en
valiant	en
vastly	en
wealthy	en
alemmalla	fi
asteittain	fi
edellisistä	fi
elämme	fi
elinympäristön	fi
epäkorrektia	fi
georgialaisen	fi
halkeisi	fi
henderson	fi
hunksit	fi
huonekasvi	fi
itäiset	fi
itsenäinen	fi
jaanintien	fi
jatkoa	fi
joutuvat	fi
kaidetta	fi
kansalaisilla	fi
kantavat	fi
katkennut	fi
katsomansa	fi
käytät	fi
kesätöitä	fi
kestämään	fi
kieltävät	fi
kiinnostumaan	fi
kiviä	fi
kivimiehineen	fi
kokeet	fi
korot	fi
köyttä	fi
kulkeva	fi
kulkija	fi
kulmahampaat	fi
läheisen	fi
lauseella	fi
levinneisyys	fi
liikevaihtonsa	fi
liitutaulutkin	fi
maakohtaisen	fi
maken	fi
malton	fi
mitalitilin	fi
mullistavaa	fi
neuvoja	fi
nollille	fi
nostamaan	fi
nurmikollani	fi
nuuskan	fi
nytkään	fi
objektiivista	fi
öljysatama	fi
omaa	fi
opinahjo	fi
opintomatkan	fi
osuneen	fi
päinvastoin	fi
pelkonsa	fi
perselihaksilla	fi
perspektiivin	fi
puhelimen	fi
puhtausnormeja	fi
rappeutunut	fi
robinson	fi
romanian	fi
ruohikolla	fi
ryppyinen	fi
sairaanhoitokortti	fi
serbijoukkojen	fi
seuraavinakin	fi
strategiani	fi
sund	fi
suomalaisia	fi
suonissaan	fi
tahoja	fi
tarkoitettuihin	fi
tarkoitetuilla	fi
toimenpidevapaa	fi
topmostista	fi
torppia	fi
tosi	fi
traagisiin	fi
trilleri	fi
tungette	fi
tunnukseksi	fi
uhoaan	fi
uudistuksia	fi
vaikuttaa	fi
vaikutukseltaan	fi
vajoan	fi
vanhasen	fi
vanhemmalla	fi
vasemmistojohtoisiksi	fi
vauhkosin	fi
vertaisverkkotekniikan	fi
vetoomuksiin	fi
vitsit	fi
yhteiset	fi
yksistään	fi
ylistää	fi
action	fr
adaptations	fr
aire	fr
allaitante	fr
allient	fr
altérée	fr
annuelle	fr
arythmie	fr
assé-le-riboulle-au-maire	fr
attaque	fr
autant	fr
avoir	fr
bankasi	fr
basculé	fr
blasphème	fr
boursier	fr
calonne	fr
cassirer	fr
collégiale	fr
comparé	fr
consécutif	fr
contini	fr
découleront	fr
défap	fr
délicieux	fr
demporos	fr
dentelées	fr
diamond	fr
dijon	fr
données	fr
eckhart	fr
ella	fr
emprise	fr
enveloppe	fr
existantes	fr
exploit	fr
fessenheim	fr
flexibilité-précarité	fr
fondant	fr
fournisseur	fr
gardons	fr
gars	fr
gujarat	fr
héberger	fr
homosexualité	fr
injectés	fr
instituées	fr
loisirs	fr
lonitzer	fr
mémorial	fr
merville	fr
microcred	fr
micro-organisme	fr
missile	fr
modèrent	fr
montasio	fr
multiplier	fr
mutiloa	fr
naufragée	fr
nazionale	fr
nécessitent	fr
oestrogène	fr
oméga	fr
optique	fr
orientaux	fr
osmosion	fr
panafricaine	fr
parlée	fr
passer	fr
pauvres	fr
placement	fr
plume	fr
posters	fr
prêcherait	fr
précisait	fr
projet	fr
prolifiques	fr
protons	fr
reino	fr
répondit	fr
saint-germain-en-laye	fr
sections	fr
serez	fr
sespros	fr
signant	fr
simultanée	fr
sloane	fr
solférino	fr
substitutions	fr
tcheu	fr
toast	fr
toyota	fr
trafalgar	fr
tunnel	fr
ucar	fr
valero	fr
vocaliste	fr
volatile	fr
wallace	fr
yate	fr
abgeweidet	de
Adams	de
Agiv	de
angenehmen	de
aufkeimenden	de
Ausstellungen	de
Benutzung	de
bespannt	de
Buchbeiträgen	de
Carmen	de
Cauca	de
derartige	de
Diplome	de
durchlöchert	de
durchzieht	de
efficiency	de
elektronischen	de
Emilia	de
Entomogamie	de
Entwicklungszentrum	de
Erlenbaches	de
Eschenbach	de
Experience	de
Fallenstopper	de
Fernsehproduktionen	de
Förderungen	de
Galatasaray	de
gallischen	de
gehfähig	de
Geotop	de
Gleisverbindung	de
Gregorianische	de
höfliche	de
inszeniert	de
katholischem	de
Kurdistan	de
Landungstrupp	de
Landwirtschaftsbetrieb	de
laßt	de
Leerstand	de
Lexikon	de
Litauischen	de
Lokalität	de
Lower	de
luden	de
Luftfiltern	de
Magdeburger	de
Marieholms	de
materialistisch	de
melden	de
Methanol	de
Millionenhöhe	de
Monats	de
multipliziert	de
Nannini	de
Normallage	de
Nutzhanf	de
Oberammergau	de
Ohrenuntersuchung	de
optischen	de
Parteifreunden	de
Phyllostachys	de
regelte	de
Reue	de
rosablasse	de
Rübennematoden	de
Russ	de
Salome	de
schnellstes	de
Sitzplatztribüne	de
Sommerregen	de
Speldorf	de
Stand	de
Sternhaufen	de
Straucharten	de
Studiums	de
Südostengland	de
Teutschland	de
Theil	de
Thyra	de
Todesschütze	de
totale	de
Totenorakel	de
überformt	de
umzuwandelnde	de
unvollendet	de
unvollständig	de
Valtion	de
veräußert	de
verschwändet	de
verstreut	de
Volljurist	de
vorbekanntem	de
weitreichender	de
Werbespot	de
Werk	de
wesentlich	de
Winterregen	de
zahlentheoretischen	de
Zeichenunterricht	de
allmänmänskliga	sv
ämnesinnehåll	sv
anpassa	sv
arabiska	sv
avgav	sv
avhåller	sv
avhållsamhet	sv
avtal	sv
barnafödandet	sv
barnstugorna	sv
bebyggelsen	sv
begränsad	sv
bekvämlighet	sv
berör	sv
beteenden	sv
betraktar	sv
bilen	sv
bostadsbeståndet	sv
brottslighet	sv
byggt	sv
cellplast	sv
corn	sv
delta	sv
deponerade	sv
dittills	sv
diverse	sv
duger	sv
dygder	sv
efterhand	sv
eftermiddagen	sv
egenskap	sv
elkraften	sv
energiproduktion	sv
enkammaren	sv
erbjuda	sv
existerande	sv
fältet	sv
färdriktningen	sv
flakes	sv
flytta	sv
följas	sv
föräldrar	sv
författare	sv
formulering	sv
försiggått	sv
förslag	sv
framöver	sv
framsteg	sv
fritt	sv
glödlamporna	sv
halvvägs	sv
iakttas	sv
inbrottsstöld	sv
infångas	sv
jakthunden	sv
kvinnligt	sv
kvinnor	sv
litteratur	sv
luktslemhinnor	sv
mänskligheten	sv
markskikt	sv
minst	sv
nedärvs	sv
oansenlig	sv
oerhörd	sv
ökades	sv
ökats	sv
ordnat	sv
överenskommelsen	sv
överskrids	sv
överst	sv
permanent	sv
plastfoliekuddar	sv
populationens	sv
potatis	sv
presenterades	sv
rakapparat	sv
russinen	sv
sämsta	sv
säsongarbetslösa	sv
själsliga	sv
självförsörjande	sv
skapelse	sv
slänger	sv
specialorgan	sv
stadsfullmäktige	sv
strävat	sv
studerats	sv
sympati	sv
tänderna	sv
tillfredsställes	sv
tillverkare	sv
trivseln	sv
upphört	sv
uppställningen	sv
urgamla	sv
utrikes	sv
väger	sv
valbåset	sv
vänder	sv
